#############################
###### WildStoneStudio ######
##### Davide Campigotto #####
#############################
########### MAP1 ############
#############################


XXXXXXXXXXXXXXXXXXXX
X                  X
X                  X
X                  X
X                  X
X                  X
X                  X
X                  X
XXXXXX         XXXXX
X                  X
X                  X
XXXXXXXXXXXXXXXXXXXX